#BOSS FIGHT RAT KING 

# 1 = parede 0 = chão 9 = spawn

11111111111111111111111111111111
19444444444444444444444444444441
14444444444444444444444444444441
14444444444444444444444444444441
14444444444444444444444444444441
14444444444444444444444444444441
14444444444444444444444444444441
14444444444444444444444444444441
14444444444444444444444444444441
14444444444444444444444444444441
14444444444444444444444444444441
144444444444444444444444444444P1
11111111111111111111111111111111