# MAPA 1 - Labirinto Grande
# 1=parede, 0=chao, 9=spawn B = Bateria M = Pente de munição J = Inimigo Rato Z = Boss Rato P = Portal
111111111111111111111111111111111111111111111111111
190000000001000000000010000000001000000000000000001
1011111111J1011111110010111111101011111111011111101
10000M000100010000010010100000001010000001000000101
1011111101110101100101101M1111111010111101111110101
100J10000000010010010000100000001010100001000010001
101010111111010010011110111110101110101111011010111
101010000001010010000010J0001010000010J001010010001
101011111101010011111010111010111111111101010011101
101000M00101010000BJ10100010100B0000000101010000101
101111110101011111101011101011111111110101011110101
100000J10101000000101000101000000000010101000010101
101110010101111110101110101011101111110101111010101
101000010100000010100010001010001000010100001010001
10101111011111101011101J111010111011010111101011111
101010000000001010001010001010000010010000101000001
101010111111101011101010101011111110011110101011101
10001010000000100000101010100000000M000010001010001
111110101111111011111010101011111111111010111010111
100000101000J01010001010101010000000001010001010001
101111101011101010101010101010111111101011101010101
10000000101000100010100010001010000010100J001010101
101111111010111110101110111110101110101111111010101
100000001010000010100010000010001010100000001010001
101110101011110010111010111011111010101111101011101
1010101J1000010010001010001000001010100010001000101
101010101111010110101111101111101010111010111110101
10101010M001010J001000001000001010000010100M0010101
101010111101011111111110111110101111101011110010101
1010100000010000000000100000101000000010000100100J1
1J1011111101111111111010111010111111111110010111101
101000000100000000B01010001010J00000000000010000101
101111110111111111101011101011111111111111110110101
100000J10000000000101000101000000000000000000010101
101110011111111110101110101011111111111111111010101
100010B00000000010100010001010000000000000001010001
111011111111111010111011111010111111111111101011111
100010000000001010001000001010100000000000101000001
101110111111101011101111101010101111111110101111101
100000100000001000100000001010001000000010100000101
101111101111111110111111111011111011111010111110101
1J0000100000000J10000B00001000001010001010000010101
101110111111111010111011111111101010101011110010101
101000000000001010001010000000101010101000010010001
10101111111110101111101011111010101010111101M111101
1000100000000010000010001000100010101000J1010000001
111010111111111111101111101011111010111101010111111
1000101000BJ000000001000001000001000100001010000001
101110101111111111111011111111101111101111011111101
1000000000000000M000000000000000000000000100ZP00B01
111111111111111111111111111111111111111111111111111
