# MAPA 1 - Labirinto Compacto
# 1=parede, 0=chao, 9=spawn B=Bateria M=Pente de munição J=Inimigo Z=Boss P=Portal
111111111111111111111111111
190000001000000010000000001
1011111J1011110010111111101
10000M101000010010100000101
10111010111101J01010111J101
10J0101000001001010001B1001
10101010111101101011101M101
10101J10100001000B10001B101
10101110101111111110111M1J1
1010000M1010B0J00010000B101
10111110101011111010111J101
10J00010101010001J1J100M101
10111010101010101110101B101
100J1010100010100M0010J0101
1011101B11111010111110111J1
100J001MJ0001010100010000M1
1011111111101010101011111J1
1010000000101010101000J00B1
1010111110101010101111111J1
10J01B00101000101000B000M01
101110101011111011111111101
1M0010101000001000000J00101
111010101011111111111110101
10J010M01010000000M00010101
101111111010111111111010101
10J0MMMM0Z1000000000J0P0B01
111111111111111111111111111
