# MAPA 1 - Labirinto Compacto
# 1=parede, 0=chao, 9=spawn B=Bateria M=Pente de munição J=Inimigo Z=Boss P=Portal
111111111111111111111111111
190000001000000010000000001
101111101011110010111111101
10000M101000010010100000101
10111010111101J01010111J101
10001010000001001010001B101
10101010111101101011101M101
10101J10100001000010001B101
10101110101111111110111M101
10100000101000J00010000B101
10111110101011111010111J101
10000010101010001J10100M101
10111010101010101110101B101
1000101010001010000010J0101
1011101011111010111110111J1
1000001000001010100010000M1
1011111111101010101011111J1
1010000000101010101000000B1
1010111110101010101111111J1
100010001010001010000000001
101110101011111011111111101
100010101000001000000J00101
111010101011111111111110101
100010001010000000M00010101
101111111010111111111010101
10000000001000000000Z0P0B01
111111111111111111111111111
