# MAPA 2 - Labirinto Subterraneo
# 1=parede, 0=chao, 9=spawn, P=portal (volta ao map1)
11111111111111111111111111111111111111111
19000000000100000000010000000001000000001
10111111010101111110010111111101011111101
10000001010100000010010100000001010000101
10111101010101110010110101111111010111101
10100001010100010010000100000001010100001
10101111010111010011110111110101110101011
10100001010001010000010000010100000100001
10101101010101011111010111010111111111011
10100100010101000001010001010000000001001
10111111110101111101011101011111111101001
10000000010100000101000101000000000101001
10111110010101110101110101011101111101001
10100010010100010100010001010001000010001
10101010110111010111010111010111011010111
10101010000001010001010001010000010010001
10101011111101011101010101011111110011101
10001010000001000001010101000000000000001
11111010111111011111010101011111111111101
10000010100001010001010101010000000001001
10111110101101010101010101010111111101001
10000000101001000101000100010100000101001
10111111101011110101110111110101110101001
10000000101000010100010000010001010100001
10111010101111010111010111011111010101111
10101010100001010001010001000001010100001
10101010101111010110101111101111010111011
10100010100001010000100000100000100001001
10101110101101011111111110111110111101001
10100000100001000000000010000010000001001
10101111111101111111111010111010111111011
10100000010001000000001010001010000000001
10111110010111111111101011101011111111011
10000010010000000000101000101000000000001
10110011011111111110101110101011111111111
10010000000000000010100010001010000000001
11011111111111111010111011111010111111101
10010000000000001010001000001010100000001
10110111111111101011101111101010101111111
10000100000000001000100000001010001000001
10111101111111111110111111111011111011101
10000100000000000010000000001000001010001
10110101111111111010111011111111101010111
10010100000000001010001010000000101010001
10010111111111101011111010111110101010111
10010000000000001000001000100010001010001
11010111111111111111101111101011111010111
10010100000000000000001000001000001000001
10110101111111111111111011111111101111101
100000000000000000000000000000000000P0001
11111111111111111111111111111111111111111