# MAPA 2 - Labirinto Subterraneo
# 1=parede, 0=chao, 9=spawn, P=portal
111111111111111111111111111
190000001000000010000000001
101111101011110010111111101
10M00J01010001001010000B101
10111101010111010101011J101
10100001010001010101010M101
10101111010101010101010B101
10100J01010101000101010M101
10111101010101110101011J101
10100001010100010100010B101
10101110010111010111110M101
1010001001000J010000010B101
1011101101011101011111J101
1000001001010001010000M101
1011111001010111010111J101
100000100101000J010100B101
101111110101011101011JM101
10J000010100010001000B0101
10111111010111111111110101
10000001010000000J00010101
10111101011111111110010101
10000101000000M00010010101
10110101011111111010110101
100101010000J0001010010101
111101010111111101011J1011
1000010100000000010000B001
10111101011111111111110P01
111111111111111111111111111
