# MAPA 2 - Labirinto Subterraneo
# 1=parede, 0=chao, 9=spawn, P=portal (volta ao map1)
11111111111111111111111111111111111111111
19000000000100000000010000000001000000001
10111111010101111110010011111101011111101
10M00001010100000010010100000001010000101
10111101010101110010110101111111010111101
101J0001010100010010000100000001010100001
10101111010111010011110111110101110101011
10100J010100010100000100000B0100000100001
10100101010101010111110101110101111111101
101001000101010000010100010100000000010M1
10111111110101111101011101011111111101001
100000J0010100000101000J01000000000101001
10111110010101110101110101011101111101001
10100010010100M1010001000101000100J010001
10101010110111010111010111010111011010111
10101010000001010001010001010000010010001
101B1011111101011J01010101011111110011101
10001010000001000001010100010000000000001
111110M0111111011111010101011111111111101
10J0001010000101000J010101010000000001001
10111110101101010101010101010111111101001
1000000010100100M101000100010100000101001
101111111010111101011101111101011101000J1
10000000101000010100010000010001010100001
10111010101111010B11010111011111010101111
10101010100001010001010001000001010100001
10101010101111010J10101111101111010111011
10M00010100001010000100000100000100001001
10101110101101011111111110111110111101001
101000001000010000J000M010000010000001001
10101111111101111111111010111010111111011
10J00000010000J00000000010100010100000001
10111110010111111111101011100011111111011
100000100100000000J010100010100000B000001
10110011011111111110101110101011111111111
1001M000000000000010100J10001010000000001
11011111111111111010111011111010111111101
10010000000000001010001000001010100000001
10001101111111111010111001111010101011111
10J0010000000000100010000000101000M000001
11111101111111111110111111111011111011101
10B0010000000000001000J000001000001010001
10110101111111111010111011111111100010111
1001010000000000101000101000000010J010001
10010111111111101011111010111110101010111
1001J000000000001000000000100010001010001
11010111111111111111101111101011111010111
100101000000000000000J1000001000001000001
10110101111111111111111011111111101111101
1000000000000000000000000000000000Z0P0001
11111111111111111111111111111111111111111