# MAPA 2 - Labirinto Subterraneo
# 1=parede, 0=chao, 9=spawn B=Bateria M=Pente de munição T=Inimigo Y=Boss P=Portal

111111111111111111111111111
1900000000000000000000000T1
111111101111111011111110111
1T00001010000010100000100T1
101110101011101010111011101
1010001M1010101010101000101
101011101010111010101110101
101000001000000T100000001T1
101111111111111011111111101
1T00B00T000010001M0000000T1
111111101110101110111011111
1T0000101000100000100010001
101110101011111110101110101
101000101000000010100000101
101011111111111010111110101
1010BT00000000101M000010101
101111111011101110111010101
101000001010000000100010101
101011101110111111101110101
1010M01000001B00000M1000101
101110111110101111101110101
10001000MB10100000100000101
111011111010111011111110111
10001T000010001000000T100T1
101011111111101111111011101
10000T000Y0000B0M0MT00001P1
111111111111111111111111111