# MAPA 3 - Labirinto da Estacao Central
# 1=parede, 0=chao, 9=spawn, P=portal
1111111111111111111111111111111111111111111111111111111
1000000000010000000001000000000100000000010000000000001
1011111110010111111101011111110101111111010111111111101
1010000010010100000101010000010101000001010100000000101
1010110010010101110101010111010101011101010101111110101
1010010010000101010001010001010001010001000101000010101
1011010011110101010111011101011111010111110101010010101
1000010000010101010100000001000001010000010101010010001
1011011111010101010101111101111101011110010101010111101
1010000001010101010101000001000101000010010101010000101
1010111101010101010101011111010101111010010101011110101
1010100001010001010001010000010100001010010001000010101
1010101111011101011111010111110111101010011101111010101
1010001000000101000001010100000000001010000001001010001
1011101011110101111101010101111111101011111101101011111
1000001010010100000101010101000000001000000101001000001
1011111010010111110101010101011111111111110101101111101
1010001000010000010001010001010000000000010101001000001
1010101111111110010111011111010111111111010101011011111
1010100000000010010001000001010100000001010101000010001
1010111111111010011101111101010101111101010101111110101
1010000000001010000100000101010100010001010100000010101
1011111111101011110111110101010111010111010111111010101
1000000000101000010100010001010001010001010000001010101
1011111110101111010101010111011101010101011111101010101
1010000010100001010101010001000001010101000000001010101
1010111010111101010101011101111111010101011111111010101
1010001010000001010001000101000001010001000100000010001
1011101010111111011111110101011101011111110101111110111
1000101010000001000000010001010001000000010101000000001
1010101011111101111110010111010111111110010101011111101
1010001000000100000010010001010000000010010001010000101
1010111111110111110010011101011111111010011101010110101
1010000000010000010010000001000000001010000001010010101
1011011111010111010011111111011111101011111101011010101
1001010001010001010000000001010000001000000101000010101
1101010101011101011111111101010111111111110101111110101
1001010101000001000000000101010100000000010100000010001
1011010101111101111111110101010101111111010111111011101
1000010100000100000000010101010100010001010000001000101
1011110111111111111111010101010111010101010111101110101
1010000000000000000001010100010001010101010100001010101
1010111111111111111101010111011101010101010101111010101
1010100000000000000101010001000001010001010101001010001
1010101111111111110101011101111111011111010101101011111
1010001000000000010001000001000000000001010100001000001
1011101011111110010111111101011111111101010111111111101
1000001010000010010000000001010000000101010000000000101
1011111010111010011111111111010111110101011111111110101
1000000010001000000000000000010000010001000000000010P11
1111111111111111111111111111111111111111111111111111111
