# MAPA 3 - Catacumba Final (Ratos + Morcegos)
# 1=parede, 0=chao, 9=spawn, P=portal
# J,T=Ratos | C,G,K=Morcegos | Z=Boss
111111111111111111111111111
190000J01000000010000000C01
101111101011110010111111101
10B00M01010001001010000G101
10111101010111010101011B101
10100001010C01010101010M101
10101111010101010101010K101
10100001010101000101010B101
10111J01010101110101011M101
10100M01010100010100010C101
10101110010111010111110B101
1010001001000G010000010M101
1011101101011101011111J101
1000001001010001010000B101
1011111001010111010111M101
10000010010100K0010100C101
101111110101011101011BM101
10J000010100010001000G0101
10111111010111111111110101
10000001010000000M00010101
10111101011111111110010101
10000101000000K00010010101
10110101011111111010110101
10010101000B0M001010010101
11110101011111110101111011
1000010100000000010000J001
1011110101111111111111ZP01
111111111111111111111111111
