# MAPA 3 - Labirinto da Estacao Central
# 1=parede, 0=chao, 9=spawn, P=portal
1111111111111111111111111111111111111111111111111111111
1090000J00010000000001000000M00100000000010000000000001
1011111110010111111101011111110101111111010111111111101
10100B00100101000J0101010000010101000001010100000000101
1010110010010101110101010111010101011101010101111110101
1010010010J00101010001010001010001010M01000101000010101
1011010011110101010111011101011111010111110101010010101
100001000001010101010J000001000001010000010101010B10001
1011011111010101010101111101111101011110010101010111101
10100M0001010101010101000001000101000J10010101010000101
1010111101010101010101011111010101111010010101011110101
1010100J010100010100010100M0010100001010010001000010101
1010101111011101011111010111110111101010011101111010101
101000100000010100000101010000J000001010000001001010001
1011101011110101111101010101111111101011111101101011111
100B0010100101000J00010101010000000010000001010010M0001
1011111010010111110101010101011111111111110101101111101
101000100001000001000101000101000J000000010101001000001
1010101111111110010111011111010111111111010101011011111
1010100000M000100100010000010101000000010101010J0010001
1010111111111010011101111101010101111101010101111110101
10100J0000001010000100000101010100010001010100000010101
1011111111101011110111110101010111010111010111111010101
1000000B00101000010100010J010100010100010100M0001010101
1011111110101111010101010111011101010101011111101010101
10100000101000010101010100010000010101010J0000001010101
1010111010111101010101011101111111010101011111111010101
10100010100000M10100010001010000010100010001000J0010001
1011101010111111011111110101011101011111110101111110111
100010101000000100000001000101000100000J010101000000001
1010101011111101111110010111010111111110010101011111101
101000100000010000001001000101000B000010010001010M00101
1010111111110111110010011101011111111010011101010110101
10100J0000010000010010000001000000001010000001010010101
1011011111010111010011111111011111101011111101011010101
100M0100010100010100000J0001010000001000000101000010101
1101010101011101011111111101010111111111110101111110101
10010101010000010000000001010101000J0000010100M00010001
1011010101111101111111110101010101111111010111111011101
1000010100000100000B00010101010100010001010000001000101
1011110111111111111111010101010111010101010111101110101
10100000J000000000000101010001000101010101Z1000M1010101
1010111111111111111101010111011101010101010101111010101
1010100000000000000101010001000J01010001010101001010001
1010101111111111110101011101111111011111010101101011111
101000100000000001000100000100000000000101010J001000001
1011101011111110010111111101011111111101010111111111101
100000101000001001000000M0010100000J0101010000000000101
1011111010111010011111111111010111110101011111111110101
1000M0000010001000000J0000M0010000010001000000000010P11
1111111111111111111111111111111111111111111111111111111